0	0	1	1	3	4	0	2	0	2	5	9	7	3	3	9	12	6	1	8	9	2	15	11	1	16	15	4	23	24	24	0	12	3	0	18	2	7	6	1	7	10	21	27	30	23	20	45	3	15	
0	1	1	2	2	4	4	1	5	4	7	7	10	2	11	12	2	7	10	4	16	2	5	14	23	11	22	5	10	14	28	28	30	21	19	32	20	27	1	36	29	29	33	18	29	33	23	17	3	43	
0	1	2	2	3	3	5	2	5	4	2	10	10	6	2	9	12	11	5	2	10	11	15	14	17	10	6	19	2	26	28	22	31	15	22	30	3	14	6	7	12	15	17	5	15	6	24	34	14	11	
2	2	2	3	3	4	5	5	5	7	8	8	9	8	13	4	12	4	14	6	16	12	12	10	13	16	20	6	12	23	22	27	29	24	28	28	12	11	29	28	16	20	13	4	22	15	44	28	16	29	
2	2	2	3	4	4	4	4	6	7	7	7	8	11	13	9	12	16	17	11	18	14	21	18	23	5	4	16	19	27	11	30	14	5	13	33	17	19	29	34	25	13	13	31	10	21	20	33	31	37	
2	3	2	3	4	5	5	5	6	5	6	7	9	5	6	10	6	10	6	5	18	5	21	20	9	24	7	22	10	26	9	16	25	19	30	5	13	29	8	14	30	24	31	22	24	26	17	46	15	13	
4	3	3	4	5	5	6	6	7	6	7	10	10	7	13	12	12	16	16	18	12	19	19	19	7	7	20	9	11	22	22	27	11	12	8	10	6	10	11	37	6	34	10	18	40	22	42	36	29	38	
6	2	2	6	4	5	6	7	7	8	8	10	9	7	11	10	7	12	14	11	8	7	20	22	9	8	8	10	21	13	10	21	29	20	10	18	18	21	37	12	13	35	22	35	25	40	8	16	37	30	
2	3	6	6	7	5	7	7	8	8	8	8	11	11	10	10	11	14	16	12	13	9	14	12	19	18	22	21	23	28	29	26	24	10	28	15	34	28	12	15	22	21	27	40	16	22	20	35	22	26	
7	1	2	4	8	5	6	7	8	9	9	10	11	9	13	9	12	15	9	16	10	10	17	13	18	16	20	23	26	19	17	25	11	31	30	10	33	16	36	11	16	32	19	14	11	12	13	37	28	37	
0	7	6	8	5	5	8	8	8	9	10	10	10	12	13	10	14	13	10	12	18	11	13	14	11	10	25	20	20	17	24	22	10	19	33	14	20	11	10	29	36	37	30	17	35	13	19	14	14	18	
4	6	10	10	7	10	9	7	9	10	10	11	11	11	13	13	15	16	17	13	13	18	17	11	21	19	11	20	17	24	18	20	16	26	30	15	11	25	14	27	18	11	26	27	34	20	37	36	44	44	
0	3	10	6	9	6	9	10	10	9	11	11	12	12	12	14	15	14	15	16	14	18	18	16	22	17	18	21	17	17	16	13	28	26	29	30	27	26	27	12	16	26	32	37	35	26	26	19	30	34	
6	2	9	9	8	11	9	11	10	9	12	11	12	13	13	13	13	13	17	16	14	17	13	16	22	21	22	22	25	28	17	20	20	17	24	31	33	17	37	17	27	36	26	29	30	35	21	43	46	26	
3	3	10	7	10	9	9	12	10	12	12	12	12	13	14	14	15	14	16	14	17	17	19	16	23	21	20	22	24	23	21	17	23	28	29	34	29	14	14	37	35	32	20	14	19	28	37	40	38	16	
2	7	14	10	14	7	14	14	10	11	14	11	13	14	14	15	15	15	16	16	15	19	21	15	16	23	17	16	15	22	24	19	23	21	26	16	25	19	19	16	38	26	36	30	25	33	44	32	15	26	
11	8	7	12	12	10	12	8	12	11	13	14	12	15	14	15	16	16	16	16	19	20	18	21	18	17	22	23	23	26	26	28	23	31	30	20	25	22	28	31	19	16	39	31	31	20	43	17	27	47	
6	6	5	8	5	12	15	7	12	15	15	13	12	14	15	15	16	17	17	18	19	17	21	20	20	19	21	19	24	21	23	25	20	20	18	28	28	36	31	18	39	19	20	24	23	22	19	24	42	40	
13	14	11	17	15	8	17	15	16	11	11	17	13	13	14	16	17	17	18	18	19	20	21	22	23	18	18	22	22	24	25	26	29	27	33	18	26	28	30	19	36	39	24	35	35	27	34	31	25	29	
15	17	15	15	12	10	16	7	17	16	16	18	12	13	18	17	17	17	18	19	19	19	19	19	19	19	23	26	21	25	19	25	20	20	19	31	25	32	25	28	31	20	39	40	37	31	34	41	27	24	
18	16	5	16	9	16	18	18	16	19	10	11	16	13	19	19	17	18	18	19	20	20	20	22	23	21	20	26	26	28	20	29	23	26	25	20	31	33	28	25	20	38	33	40	35	37	22	36	30	46	
4	14	20	4	15	19	10	13	10	10	18	18	14	16	17	18	16	18	18	19	20	21	21	22	21	22	22	21	21	25	28	30	22	24	29	25	29	33	34	36	21	27	28	36	33	22	23	26	31	46	
11	1	21	16	10	12	8	19	21	15	20	13	17	21	14	17	16	20	21	20	20	21	22	22	23	24	23	22	25	22	28	25	23	22	23	29	28	35	26	36	22	39	24	38	38	29	27	27	39	42	
3	21	4	11	8	19	13	16	22	18	15	19	21	13	19	19	19	22	21	19	20	22	22	23	23	23	23	23	27	26	23	24	30	24	32	28	26	24	32	25	36	32	29	24	30	26	38	29	25	34	
5	8	2	21	17	20	23	17	19	17	10	15	14	14	23	19	23	21	23	22	22	23	23	23	24	24	24	26	25	28	29	27	25	29	25	25	29	29	36	30	30	37	30	25	27	42	32	44	47	34	
16	11	22	15	24	9	13	19	17	10	23	16	14	14	24	15	23	24	24	20	21	23	24	24	24	25	25	26	27	28	25	30	31	29	29	29	30	28	37	27	29	38	29	34	42	32	42	42	27	40	
16	18	15	9	24	22	20	8	23	25	16	17	25	23	15	24	16	22	18	20	25	22	22	24	25	25	26	26	26	27	29	28	26	29	26	29	30	33	34	36	35	35	32	32	26	33	28	45	47	38	
20	3	10	8	16	15	7	26	16	14	22	23	21	18	19	22	21	25	18	19	23	21	22	24	25	26	26	27	27	28	27	27	29	29	33	34	33	34	31	27	28	39	40	31	39	36	32	31	45	39	
1	16	12	24	23	5	18	15	15	18	18	25	17	25	21	15	21	25	19	20	25	26	23	26	26	25	26	27	28	28	28	29	31	29	33	28	29	30	33	32	29	39	37	29	31	29	33	36	45	48	
8	12	28	6	19	21	22	26	13	12	16	11	27	18	21	21	21	22	25	23	21	25	23	28	28	28	27	28	28	29	29	29	30	31	29	29	30	36	29	32	33	36	31	32	43	40	45	40	37	33	
28	28	26	20	4	16	12	25	20	19	20	14	16	16	18	16	28	26	18	21	28	22	23	28	24	27	27	28	28	29	30	30	31	30	31	34	31	31	35	37	39	34	39	32	33	34	42	45	37	39	
5	11	29	7	6	19	21	8	30	14	12	26	14	26	26	16	18	20	28	25	22	21	26	29	25	28	28	30	29	29	30	31	31	31	31	32	34	35	31	36	32	32	33	32	36	31	41	40	34	43	
26	14	31	29	21	8	15	28	10	16	29	22	13	26	21	27	26	31	28	29	27	29	30	28	27	26	31	27	29	30	30	31	32	32	33	32	32	36	33	32	39	32	35	36	33	35	38	38	42	45	
18	23	6	16	8	26	25	22	32	12	15	12	12	16	28	31	30	21	25	28	26	32	31	28	31	32	28	30	31	30	30	31	32	33	33	34	33	34	37	34	33	35	35	42	36	38	36	46	47	43	
12	15	16	10	33	27	15	25	10	17	30	24	30	20	17	22	29	21	28	21	22	27	30	31	25	25	29	33	31	30	30	32	33	33	34	34	35	35	37	37	36	37	41	39	36	36	45	37	35	35	
28	2	12	21	16	29	8	7	13	21	13	28	12	26	24	33	22	30	25	24	26	32	27	33	28	25	29	27	30	31	34	33	33	33	34	35	35	35	37	36	39	37	37	35	36	41	37	45	44	42	
27	9	5	24	35	13	30	33	18	9	34	29	20	23	18	21	18	32	26	29	29	28	35	28	32	31	31	33	30	33	33	33	34	35	34	35	36	36	37	38	39	38	41	36	38	36	41	44	38	42	
31	33	8	24	5	16	30	26	14	14	21	18	17	17	19	15	29	23	28	22	35	21	25	23	30	27	32	36	28	32	34	34	32	33	35	36	36	37	37	37	37	37	37	38	42	39	42	42	41	41	
22	8	26	32	8	24	21	35	18	14	37	14	18	31	25	29	30	25	29	24	24	33	28	25	36	37	34	31	33	37	37	33	34	34	36	37	36	37	38	38	38	39	40	39	43	38	40	41	42	42	
1	35	26	14	35	13	13	22	24	22	15	15	34	29	32	21	30	24	29	33	34	31	37	30	26	26	34	35	38	32	34	38	36	36	34	36	37	37	38	39	39	40	39	39	43	39	39	40	39	43	
3	31	8	7	28	6	19	36	23	39	15	12	16	23	27	31	24	26	38	36	33	36	30	37	39	27	26	29	32	37	33	38	36	39	34	35	37	39	38	39	40	40	41	42	40	42	42	44	42	45	
18	37	33	8	27	30	11	21	22	39	35	35	40	20	23	34	28	36	37	38	24	29	40	40	35	35	32	29	38	40	37	32	32	39	35	40	37	37	40	40	40	41	41	41	41	43	45	45	44	44	
9	29	35	30	30	13	6	7	11	13	20	32	37	20	32	40	28	41	27	20	35	28	38	38	33	31	41	28	33	41	41	36	34	34	41	37	40	41	39	40	40	41	42	42	42	43	44	45	47	42	
1	6	6	24	38	20	35	23	21	41	28	38	14	14	22	40	32	32	33	19	39	27	22	42	26	38	40	42	29	36	36	39	33	37	39	42	39	39	38	41	40	41	42	43	43	44	43	43	44	44	
38	6	19	33	17	19	21	28	33	9	42	30	21	14	39	22	36	21	36	27	39	43	43	42	41	42	26	39	40	39	36	31	43	33	34	35	43	37	38	42	43	42	43	43	44	44	45	44	44	48	
25	8	26	42	13	27	7	32	43	24	16	17	36	38	29	30	40	30	24	44	42	24	37	32	24	36	26	31	43	37	42	39	32	36	43	38	43	39	39	42	42	43	44	43	44	45	45	46	45	47	
38	33	8	22	38	17	16	45	9	35	20	29	42	21	19	44	21	20	37	31	45	30	38	43	24	31	26	38	40	33	43	44	35	34	42	43	43	37	43	41	42	44	43	43	45	45	46	46	47	46	
45	13	36	41	27	11	24	24	10	17	27	15	15	24	45	44	36	28	18	26	26	23	41	26	44	37	37	33	36	46	46	37	40	46	35	45	36	45	43	41	45	42	45	45	45	45	46	47	47	47	
5	40	47	17	29	33	10	11	15	20	32	42	30	30	34	44	34	17	27	23	46	38	22	26	44	35	29	30	36	44	42	39	40	40	47	39	40	37	47	39	40	44	44	44	44	47	46	47	48	48	
13	19	2	15	47	48	28	28	9	11	15	27	42	32	43	17	21	28	37	22	34	38	39	44	25	41	34	36	45	35	45	31	48	46	39	47	43	38	39	43	41	48	43	46	45	48	47	47	48	49	
